***********
*         *
*         *
*         *
*         *
*         *
*         *
*         *
***********